NO  ./txr/test.xpm

SO  ./txr/Wall2.xpm

WE  ./txr/Wall3.xpm

EA  ./txr/Wall4.xpm

C   150 , 170 , 225 

F   130 , 100 , 130

        1111111111111111111111111
        1000000000110000000000001
        1011000001110001100000001
        1001000000000000100000001
111111111011000001110000000000001
100000000011000001110111111111111
11110111111111011100000010001
11110111111111011101010010001
11000000110101011100000010001
10000000000000001100000000001
10000000000000001101010010001
110000011101010111110111100N1
11110111 1110101 101111010001
11111111 1111111 111111111111
