NO  ./txr/test.xpm

SO  ./txr/Wall2.xpm

WE  ./txr/Wall3.xpm

EA  ./txr/Wall4.xpm

C   150 , 170 , 225 

F   130 , 100 , 130

1111111111
1N00000001
1011000001
1001000000
1111111111
