NO  ../txr/sand_basic.webp

SO  ../txr/sand_clean.webp

WE  ../txr/sand_end.webp 

EA  ../txr/sand_stone.webp 

F   200,100,255

C   225,30,0

11111111
10000P01
1N000001
11111111
